####################
#   ^    #    v   #
#   #         #   #
#        #        #
#   D    #    D   #
####################
